XXXXXSXXXXXXXXXXXXXXX
XXXXX XXXXXXX       X
X     XXXXXXX XXXXXXX
XXXXX           XX XX
XXXXXXXX X XXXX XX XX
XXXXXXXX X XXXX XX XX
XXXXXXX  XXXXXX XXXXX
XXXXX   XXXXX   XXXXX
XXXXXXXEXXXXXXXXXXXXX
